#map meadow
    :size 9 9
    :tileset grass

0 1 2  0 1 2  0 1 2
3 4 5  3 4 5  3 4 5
6 7 8  6 7 8  6 7 8

0 1 2  0 1 2  0 1 2
3 4 5  3 4 5  3 4 5
6 7 .  6 7 8  6 7 8

0 1 2  0 1 2  0 1 2
3 4 5  3 4 5  3 4 5
6 7 8  6 7 8  6 7 8
